"filename", "language", "C", "C++", "comment", "blank", "total"
"/home/kali/Desktop/cybersec/sem1/programowanie/Femsy/FemsyInC/engine/polynomial/Poly.h", "C", 35, 0, 2, 7, 44
"/home/kali/Desktop/cybersec/sem1/programowanie/Femsy/FemsyInC/engine/polynomial/PolyAdd.c", "C", 35, 0, 0, 15, 50
"/home/kali/Desktop/cybersec/sem1/programowanie/Femsy/FemsyInC/engine/polynomial/PolyAddTest.c", "C", 36, 0, 0, 12, 48
"/home/kali/Desktop/cybersec/sem1/programowanie/Femsy/FemsyInC/engine/polynomial/PolyCompare.c", "C", 20, 0, 3, 3, 26
"/home/kali/Desktop/cybersec/sem1/programowanie/Femsy/FemsyInC/engine/polynomial/PolyCreate.c", "C", 29, 0, 0, 2, 31
"/home/kali/Desktop/cybersec/sem1/programowanie/Femsy/FemsyInC/engine/polynomial/PolyHelper.c", "C", 39, 0, 0, 9, 48
"/home/kali/Desktop/cybersec/sem1/programowanie/Femsy/FemsyInC/engine/polynomial/PolyHepler.h", "C++", 0, 10, 0, 1, 11
"/home/kali/Desktop/cybersec/sem1/programowanie/Femsy/FemsyInC/engine/polynomial/PolyMultiply.c", "C", 38, 0, 0, 12, 50
"/home/kali/Desktop/cybersec/sem1/programowanie/Femsy/FemsyInC/engine/polynomial/PolySubtract.c", "C", 11, 0, 0, 3, 14
"Total", "-", 243, 10, 5, 64, 322